00000000000000000000000000000000000000000000000000000000000000000000000000000000000000000000000000000000000000000000000
00000000000000000000000000000000000000000000000000000000000000000000000000000000000000000000000000000000000000000000000
00000000000000000000000000000000000000000000000000000000000000000000000000000000000000000000000000000000000000000000000
000000000000000000000000000000000000000000000000000000000000000000000000000000000000000000000000000000000000000000000003
000000000000000000000000000000000000000000000000000000000000000000000000000000000000000000000000000000000044400000000111
000000000000000000000000000000000000000000000000000000000000000000000000000000000000000000000000000000000411140000001111
000000000000000000000000000000000000000000000000000000000000000000000001111100000000000000000000000000041111140000111111
000000000000000000000000000000000044400000000000000000011110000000000011111110000000000000000000000004111111140011111111
000000000000000000000000000000000411140000000000000000111111000000000111111111000000000001111000000411111111141111111111
00000000000000000000000000000041111140000000000000011111111000000011111111111000000001111111100041111111111411111111111
000011110000041140000011110000411111114000001111000111111111100000111111111111000000111111111114111111111114111111111111
000111111000411114000111111004111111111400011111101111111111110001111111111111000011111111111114111111111114111111111111
011111111104111111401111111141111111111140111111111111111111111011111111111111100111111111111111411111111111411111111111
111111111111111111111111111111111111111111111111111111111111111111111111111111111111111111111111111111111111111111111111
111111111111111111111111111111111111111111111111111111111111111111111111111111111111111111111111111111111111111111111111

