2222222222000000000000000000000000000000000000000000000000000000000000000000000000000000000000000000000000000000000000000000000000000000000000000000000000002222222222
2222222222000000000000000000000000000000000000000000000000000000000000000000000000000000000000000000000000000000000000000000000000000000000000000000000000002222222222
2222222222000000000000000000000000000000000000000000000000000000000000000000000000000000000000000000000000000000000000000000000000000000000000000000000000002222222222
2222222222000000000000000000000000000000000000000000000000000000000000000000000000222222222222222222000000000000000000000000000000000200000000000000000000002222222222
2222222222000000000000000000000000000000000000000000000000000000000000000000000022000000000000000002000000000000000000000000000000000222000000000000000000002222222222
2222222222000000000000000000000000000000000000000000000000000000000000000000000000000000000000000002220000000000000000000000000000200200000000000000000000002222222222
222222222200000000000000000000000000000000000000000000000000000000000000000000000000000000000000000200000000000000000000000e000e00000200220000000000000000002222222222
222222222200000000000000044400000e00000000000000000000000000000000000000000e0022200e000e0000e0000e02000022200000000000222222222222222200000000000000000000002222222222
222222222200000000000022222222222222220000000000000000000000000000e000222222000022222222222222222222000000000000222200000000000000000000002200000000000000002222222222
2222222222000000400000000000000000000200000000000000000000000e00222222000000000000000000000000000000000000000000000000000000000000000000000000000000000000002222222222
2222222222000000222200000000000000000200000000000000000000022222000000000000000000000000000000000000000000022220000000000000000000000000000000000000000000002222222222
22222222220000000000044444444444444442000044440044440044440000000000000000000004000000400044000000044400222000000044440000000000000000000000000000003000000022222222222
2222222222111111111111111111111111111111111111111111111111111111111111111111111111111111111111111111111111111111111111111111111111111111111111111111111111112222222222
2222222222111111111111111111111111111111111111111111111111111111111111111111111111111111111111111111111111111111111111111111111111111111111111111111111111112222222222
2222222222111111111111111111111111111111111111111111111111111111111111111111111111111111111111111111111111111111111111111111111111111111111111111111111111112222222222