22222222220000000000000000000000000000000000000000000000000000000000000000000000000000000000000000000000000000000000000000000000000000000000000000000000000000000000000000000000002222222222
22222222220000000000000000000000000000000000000000000000000000000000000000000000000000000000000000000000000000000000000000000000000000000000000000000000000000000000000000000000002222222222
22222222220000000000000000000000000000000000000000000000000000000000000000000000000000000000000000000000000000000000000000000000222222222222222222220000000000000000000000000000002222222222
22222222220000000000000000000000000000000000000000000000000000000000000000000000000000000000000000000000000000000000000000000000200000000000000000000000000000000000000000000000002222222222
22222222220000000000000000000000000000000000000000000000000000000000000000000000000000000000000000000000000000000000000000000000200000000000000000000000000000000000000000000000002222222222
22222222220000000000000000000000000000000000440000000000000000000000000000000000000000000000000000000000000000000000000000000000200000000000000000000000000000000000000000000000002222222222
222222222200000000000000000000000000000002222200000e000e0000000000000000000000000000000000000000000000000000e0044400000000000000200000000002222000020000000000000000000000000000002222222222
22222222220000000000000000000000022220000000000222222222220000000000000000000000000000000022444442220000222222222200000e00000000000000000000000000020002220020020000000000000000002222222222
22222222220000000002200000220000000000440000000000000000000000000000200000000000000000022222222222220000000000000000222222222000000000000000000002220000000000000000000000000000002222222222
222222222200000000e00000e0004400000000222222000000000000000002000000000000002000200200000000000000000000000000000000000000000220000000000000000000020000000000000200000000000000002222222222
22222222220000000222222222222200000000000000000000000000000000000020000002000000000000000000000000000000000000000000000000000022000000000h00000000020000000000000000000000000000002222222222
22222222220000000000000000000004444444444444444444444444444444444444444444444444444444000000000044444400000044000000000000000000222222222222222222220444444444400002000300000000002222222222
22222222221111111111111111111111111111111111111111111111111111111111111111111111111111111111111111111111111111111111111111111111111111111111111111111111111111111111111111111111112222222222
22222222221111111111111111111111111111111111111111111111111111111111111111111111111111111111111111111111111111111111111111111111111111111111111111111111111111111111111111111111112222222222
22222222221111111111111111111111111111111111111111111111111111111111111111111111111111111111111111111111111111111111111111111111111111111111111111111111111111111111111111111111112222222222