2222222222000000000000000000000000000000000000000000000000000000000000000000000000000000000000000000000000000000000000000000000000000000000000000000000000002222222222
2222222222000000000000000000000000000000000000000000000000000000000000000000000000000000000000000000000000000000000000000000000000000000000000000000000000002222222222
2222222222000000000000000000000000000000000000000000000000000000000000000000000000000000000000000000000000000000000000000000000000000000000000000000000000002222222222
2222222222000000000000000000000000000000000000000000000000000000000000000000000000000000000000000000000000000000000000000000000000000000000000000000000000002222222222
2222222222000000000000000000000000000000000000000000000000000000000000000000000000000000000000000000000000000000000000000000000000000000000000000000000000002222222222
22222222220000000000000000000000000000000000000040000e0000040000000000000000000000000000000000000000000000000000000000000000000000000000000000000000000000002222222222
2222222222000000000000000000000000000000000000002222222222220000004400000000000000000000000000000000000000000000000000000000000000000000000000000000000000002222222222
2222222222000000000000000000000000000000002220000000000000000022222222244422000000000000000000000000000000000000000000000000000000000000000000000000000000002222222222
222222222200000000000000000000000000000000000000000000000000002222222222222200000000000000000000000000000000000000000000000000e00000e000000000000000000000002222222222
2222222222000000000000000004400000000222000000000000000000000000000000000000000222222000000000000000000000000220000000000000222222222220000000000000000000002222222222
2222222222000000022222444222200000000000000000000000000000000000000000000000000000000000040000e00000400000000220000000000000000000000000000000000000000000002222222222
2222222222000002222222222222244400000004444444444444444444444444444444444444444444444000022222222222200000000224440000444000000000000000000000030000000000022222222222
2222222222111111111111111111111111111111111111111111111111111111111111111111111111111111111111111111111111111111111111111111111111111111111111111111111111112222222222
2222222222111111111111111111111111111111111111111111111111111111111111111111111111111111111111111111111111111111111111111111111111111111111111111111111111112222222222
2222222222111111111111111111111111111111111111111111111111111111111111111111111111111111111111111111111111111111111111111111111111111111111111111111111111112222222222
